


    F    47   ,   127   ,   77    


      NO         assets/tex1.xpm



             SO               assets/tex3.xpm

 C 119,  181  , 254

 WE        assets/tex2.xpm



EA assets/tex4.xpm

         
     
11111111111111111111111111111  
10000000000000000000000000001     
10010000001000000000000000001                    
10000000000000000000100000001111     
100000000000001000111110000000001  
100000010000000000111110000000001                11111111111111111111111111
100000000000000000111110000000001                10000000011111 10000000001
100000000000000000111110000000001                11001001000001110000011101
100000000000001000111110010000001                10111111000000000100000101
100000000000000000111110000000001                 111111111111111111111111111111
10000010000000000000000000001111                  111    11011111111111111111
11000100011010001000100010001                     1111111110111000000000011111111111111111
10000000000000000000000000001                     1111111111111101111111111111111111111
10000000000000000000001000001                     10000000110000000000111101
1000000111000000000000000001111                    10110110110001111100011111                                  1
1000101   1000000000000000000011                 110001111111111  1101111                                     1N1
1000001    1000000000000000000001                  11011           11111                                       1
1000001  1  1000000000000000000001                 11111 
1000001    11100000000000000000011
1000001   1000000000000001000001 
1000000111000000000000000000011  
10000011111111111110000000001  
1111111111000000000000000000011111111
         10000000100000000100000000001
         10000000100000000000000000001
         10000000100000000000000000001
         10000000100000000100000000001
         11000000110000000000000000001
1111111110000000000000000000111111111
10000111111111111111111100001
10000000000001000000000000001
10000000000001000000000000001
10000000000001000100000000001
10000000000001000000000000001
10000000000001000000000000001
10000000000001000000000000001
10000000000000000000000000001
111111111100000000001111111111
         10000000001
         110000000011
          110000000001
          111100011111
           10000000011
          111110011111
           11 11000111
              11111
                          